...........S
............
....*.......
...*........
..*.........
G...........  
