...........G
............
....*.......
...*........
..*.........
S...........  
